Grenl = Goblin
Bronze Scout = Construct, Arctic
Firenewt Warlock of Imix = Lizardfolk, Volcano
Orond Gralhund = Waterdeep
Servitor Thrull = Cultist
Barovian Witch = Strahd
Gnoll = Tabaxi
Quasit = Underdark
Pirate First Mate = Sea, Coast
Vegepygmy = Forest, Underground, Jungle
Sylgar = Thieves' Guild
Crag Cat = Mountain
Female Steeder = Underdark
Flying Sword = Construct
Ox = Plains, Domestic
Broom of Animated Attack = Strahd
Augrek Brighthelm = Bryn Shander
Amphisbaena = Yuan-Ti
Redbrand Ruffian = Phandalin
Noska Ur&#x27;gray = Thieves' Guild
Zombie = Undead, Grung
Young Kruthik = Underdark
Cockatrice = Genasi, Plains, Tropical
Rakdos Performer, Fire Eater = Cultist, Cult of Rakdos
Riding Horse = Plains, Domestic
Abyssal Chicken = Abyss
Sea Horse = Sea
Giant Poisonous Snake = Desert, Forest, Plains, Swamp, Underdark, Urban, Yuan-Ti
Elemental Spirit = Genasi
Cat = Desert, Forest, Plains, Urban
Swarm of Ravens = Kenku, Forest, Hill, Swamp, Urban
Fastieth = Lizardfolk
Octopus = Sea
Weasel = Hill, Forest, Plains, Urban, Fey
Giant Weasel = Hill, Forest, Plains, Fey
Talisolvanar &quot;Tally&quot; Fellbranch = Waterdeep
Giant Wolf Spider = Coast, Desert, Forest, Plains, Hill
Almiraj = Hill, Forest, Plains, Fey, Desert
Monodrone = Construct, Arctic
Yellow Musk Zombie = Jungle
Wolf = Forest, Hill, Plains
Winged Kobold = Kobold, Dragonborn
Volothamp &quot;Volo&quot; Geddarm = Wanderer
Violet Fungus = Underdark, Jungle
Velociraptor = Lizardfolk
Troglodyte = Lizardfolk, Underground, Underdark
Tortle = Coast, Wanderer
The Wretched = Undead, Cultist
Tabaxi Minstrel = Wanderer
Lycanthropickle = Shifter, Cultist, Urban
Kobold Underling = Kobold
Kobold = Kobold
Mongrelfolk = Underground, Urban
Swarm of Rats = Swamp, Urban
Erky Timbers = Sunless Citadel
Giant Owl = Arctic, Forest, Hill, Fey
Maxeene = Waterdeep
Deep RothÃƒÆ’Ã‚Â© = Underdark
Swarm of Books = Aarakocra, Mages
Swarm of Bats = Hill, Mountain, Underdark, Urban, Underground, Strahd
Bone Whelk = Underground, Underdark, Swamp, Undead
Kobold Inventor = Kobold
Panther = Forest, Grassland, Hill, Jungle, Tabaxi
Giant Crab = Coast, Sea
Flumph = Underdark
Lizard = Lizardfolk, Jungle, Desert
Servo = Construct, Arctic
Bepis Honeymaker = Thieves' Guild
Camel = Desert, Domestic
Na = Human